**************
**           *
*  *   *
*  *** * 
*  * * *
*  *** *  @  *
*            *
*****        *
**************